map                                
HHHHHHHHHHHHHHHHHHHHHHHHHHHHHHHHHHH
H        MM             MM        H
HMMMPMMMMMMMMMMMMMMMMMMMMMMMMM MMMH
H  M M   M   MM     MM   M     M  H
H  MMM   MMMMMMMMMMMMMMMMM     M  H
H   MM     MM  MMMMM  MM     MM   H
H   MM     MM  MMMMM  MM     MM   H
H  M     MMMMMMMMMMMMMMMMM   MMM  H
H  M     M   MM     MM   M   M M  H
HMMM MMMMMMMMMMMMMMMMMMMMMMMMMTMMMH
H        MM             MM        H
HHHHHHHHHHHHHHHHHHHHHHHHHHHHHHHHHHH