map                                
HHHHHHHHHHHHHHHHHHHHHHHHHHHHHHHHHHH
H                                 H
HMMMPMMMMMMMMMMMMMMMMMMMMMMMMM MMMH
H  M     M               M     M  H
H  M     MMMMMMMMMMMMMMMMM     M  H
H              MMMMM              H
H              MMMMM              H
H  M     MMMMMMMMMMMMMMMMM     M  H
H  M     M               M     M  H
HMMM MMMMMMMMMMMMMMMMMMMMMMMMMTMMMH
H                                 H
HHHHHHHHHHHHHHHHHHHHHHHHHHHHHHHHHHH