map2                                                              
HHHHHHHHHHHHHHHHHHHHHHHHHHHHHHHHHHHHHHHHHHHHHHHHHHHHHHHHHHHHHHHHHH
H                                                                H
H        P                                                       H
H                                                                H
H                                                                H
H                                                                H
H                                                                H
H                           MM   MM                              H
H                          M  M M  M                             H
H                         M    M    M                            H
H                         M         M                            H
H                          M       M                             H
H                           M     M                              H
H                            M   M                   T           H
H                             M M                                H
H                              M                                 H
H                                                                H
H                                                                H
H                                                                H
H                                                                H
HHHHHHHHHHHHHHHHHHHHHHHHHHHHHHHHHHHHHHHHHHHHHHHHHHHHHHHHHHHHHHHHHH