map                                         
HHHHHHHHHHHHHHHHHHHHHHHHHHHHHHHHHHHHHHHHHHHH
H                                          H
H     P                                    H
H      MMM                      MMM        H
H                                          H
H                                          H
H                                          H
H                                          H
H                                          H
H                                          H
H                                          H
H                                          H
H      MMM                      MMM        H
H                                   T      H
H                                          H
HHHHHHHHHHHHHHHHHHHHHHHHHHHHHHHHHHHHHHHHHHHH