map3                                        
HHHHHHHHHHHHHHHHHHHHHHHHHHHHHHHHHHHHHHHHHHHH
H                                          H
H                                          H
H      MMM                      MMM        H
H                                          H
H                                          H
H                                          H
H                                          H
H                                          H
H                                          H
H                                          H
H                                          H
H      MMM                      MMM        H
H                                          H
H                                          H
HHHHHHHHHHHHHHHHHHHHHHHHHHHHHHHHHHHHHHHHHHHH