mapMMMMMMMMMMMMMMMMMMMMMMMMMMMMMMMMMMMMMMMMM
HHHHHHHHHHHHHHHHHHHHHHHHHHHHHHHHHHHHHHHHHHHH
HMMM M MMMMMMMMMMMMMMMMMMMMMMMMMMMMMMMMMMMMH
HMM M P M M  MMMMMMMMMMMMMMMMMMMMMMMMMMMMMMH
HMMMMM MMMMMMMMMMMMMMMMMMMMMMMMMMMMMMMMMMMMH
HMMM    M MMMMMMMMMMMMMMMMMMMMMMMMMMMMMMMMMH
HMMMMMMMMMMMMMMMMMMMMMMMMMMMMMMMMMMMMMMMMMMH
HMMMM MMMMMMMMMMMMMMMMMMMMMMMMMMMMMMMMMMMMMH
HMMMMMMMMMMMMMMMMMMMMMMMMMMMMMMMMMMMMMMMMMMH
HMMMMMMMMMMMMMMMMMMMMMMMMMMMMMMMMMMMMMMMMMMH
HMMMMMMMMMMMMM MMMMMMMMMMMMMMMM   MMMMMMMMMH
HMMMMMMMMMMMMMMMMMMMMMMMMMM   MMMMMMMMMMMMMH
HMMMMMMMMMMMMMMMMMMMMMMMMMMMMMMMMM     MMMMH
HMMMMMMMMMMMMMMMMMMMMMMMMMMMMMM   MM MMMMMMH
HMMMMMMMMMMMMMMMMMMMMMMMMMMMMMMMMMM T  MMMMH
HMMMMMMMMMMMMMMMMMMMMMMMMMMMMMMMMMMM MMMMMMH
HHHHHHHHHHHHHHHHHHHHHHHHHHHHHHHHHHHHHHHHHHHH