map            
HHHHHHHHHHHHHHHH
HP  M  MM  M   H
H MHM  HH  MHM H
HMHMMMM MMMMMHMH
M    MM HMM    M
HMHMMMM MMMMMHMH
H MHM  HH  MHM H
H   M  MM  M  TH
HHHHHHHHHHHHHHHH